11111111111111111111111111111111
11000000000000000000000000000011
10000000000000000000000000000001
10000000000000000000000000000001
10000000000000000000000000000001
10000000000000000000000000000001
10000000000100001000000100000001
10000000000000000000000000000001
10000010000000000000000000000001
10000000000000000000000000000001
10000000000000000000000000000001
10010000000000000000000000000001
10000000000000000000000000000001
10000000000000000000000000000001
10000010000000000000000000000001
10000000000000000000000000000001
10000000000000000000000000000001
10000000000000000000000000000001
10010000000000000000000000000001
10000000000000000000000000000001
10000000000000000000000000000001
10000000000000000000000000000001
10010000000000000000000000000001
10000000000000000000000000000201
10000000000000000000000000011111
10000000000000000000000000000001
10010000000000000000000000000001
10000000000000000000000000000001
10000110000000000000000000000001
10000000000000000000000000000001
11000000000000000000000000000011
11111111111111111111111111111111