11111111111111111111111111111111
11000000000000000000000000000011
10000000000000000000000000000001
10002000000000000000000000000001
11111111111000000000000000000001
10000000000000000000000000000001
10000000000000100000000000000001
10000000000000000000000000000001
10000000000000000001000000000001
10000000000000000000000100000001
10000000000000000000000011000001
10000000011000000000000000000001
10000000000000000000000000001111
10000100000000010000000000000001
10000000000000000000000011100001
10000000000000000001000000000001
10000000000000000000000000000001
11110000000000000000000000000001
10000000000011000000000000000001
10000001100000000000000000000001
10000000000000000000000000000001
10000000000000011100000000000001
10000000000000000000000000000001
10000000000000000000000000000001
10000000000000000000100100000001
10000000000000000000000000000001
10000000000000000000000000000001
10000000000000000000000000000001
10000000000000000000000000111001
10000000000000000000000000000001
11000000000000000000000000000011
11111111111111111111111111111111