11111111111111111111111111111111
11000000000000000000000000000011
10000000000000000000000000000001
10000000000000000000000000020001
10000000000000000000000111111111
10000000000000010001000000000001
10000000110000000000000000000001
10000000000000000000000000000001
10000000000000000000000000000001
11000000000000000000000000000001
10000000000000000000000000000001
10000000011000000000000000000001
10000000000000000000000000000001
10000100000000010000000000000001
10000000000000000000000000000001
10000000000000000000000000000001
10000000000001000000000000000001
10000000000000000000000000000001
10000000000000000000000000000001
10000001100000000000000000000001
10000000000000000000000000000001
10000000000000000000000000000001
10000000001111000001000000000001
10000000000000000000000000000001
10000000000000000000000000000001
10000000000000000000011100000001
10000000000000000000000000000001
10000000000000000000000000000001
10000000000000011100000000000001
10000000000000000000000000000001
11000000000000000000000000000011
11111111111111111111111111111111